213, 426, 208, 78, 221, 60, 237, 57, 395, 54, 411, 64, 417, 141,
406, 155, 321, 157, 296, 172, 298, 294, 315, 317, 337, 307, 387, 248,
425, 223, 456, 230, 518, 300, 520, 328, 489, 358, 485, 463, 498, 482,
588, 485, 608, 500, 611, 556, 663, 566, 683, 553, 693, 517, 689, 398,
672, 376, 639, 374, 614, 356, 606, 218, 626, 198, 678, 201, 691, 220,
693, 277, 712, 294, 756, 292, 757, 177