211, 466, 222, 441, 247, 424, 326, 423, 354, 468, 376, 468, 391,
431, 418, 413, 428, 396, 430, 349, 416, 330, 387, 343, 385, 370, 317,
372, 295, 343, 264, 336, 253, 353, 240, 374, 223, 364, 213, 351, 212,
260, 250, 221, 249, 194, 222, 175, 212, 148, 241, 139, 420, 136, 449,
178, 467, 179, 475, 149, 512, 136, 521, 165, 519, 218, 494, 230, 474,
237, 474, 354, 506, 380, 515, 404, 512, 418, 463, 423, 445, 438, 434,
468, 433, 528, 449, 555, 481, 565, 532, 559, 554, 552, 561, 531, 589,
518, 636, 517, 655, 533, 677, 560, 704, 565, 744, 564, 765, 553, 779,
521, 757, 514, 714, 516, 701, 502, 685, 471, 664, 467, 658, 446, 675,
424, 716, 422, 735, 413, 737, 383, 708, 364, 695, 345, 676, 325, 546,
327, 522, 303, 521, 280, 569, 276, 586, 266, 589, 241, 573, 218, 572,
206, 586, 187, 605, 182, 626, 184, 639, 200, 646, 224, 626, 249, 629,
270, 657, 277, 685, 274, 691, 183, 669, 171, 647, 142, 616, 129, 609,
99, 585, 89, 566, 88, 551, 61, 537, 40, 505, 38, 463, 40, 444, 52,
437, 74, 417, 85, 184, 88