245, 310, 269, 311, 269, 290, 281, 278, 311, 270, 339, 270, 353,
277, 378, 266, 393, 259, 425, 270, 462, 266, 492, 259, 505, 267, 516,
288, 501, 306, 499, 324, 500, 339, 484, 348, 473, 365, 464, 391, 459,
422, 446, 445, 453, 473, 478, 464, 500, 431, 536, 449, 554, 459, 558,
494, 572, 526, 596, 553, 622, 561, 643, 551, 645, 531, 643, 515, 622,
496, 614, 474, 613, 447, 600, 433, 564, 429, 549, 416, 545, 399, 562,
381, 578, 381, 587, 360, 589, 346, 608, 346, 613, 363, 614, 381, 637,
384, 667, 384, 679, 370, 705, 360, 732, 364, 751, 387, 768, 394, 774,
376, 769, 352, 736, 333, 709, 325, 705, 306, 714, 284, 731, 286, 742,
299, 770, 309, 779, 295, 778, 282, 764, 267, 766, 251, 781, 242, 782,
221, 781, 173, 768, 151, 746, 137, 698, 115, 675, 103, 644, 104, 631,
124, 627, 139, 566, 148, 544, 146, 545, 103, 535, 96, 515, 121, 470,
120