254, 498, 300, 424, 297, 353, 295, 318, 331, 307, 359, 298, 382,
325, 387, 356, 374, 388, 372, 407, 395, 423, 438, 475, 445, 522, 456,
555, 497, 561, 544, 596, 570, 601, 590, 582, 594, 517, 591, 447, 625,
415, 631, 386, 628, 347, 647, 316, 680, 295, 713, 303, 746, 297, 752,
272, 743, 236, 720, 200, 676, 173, 639, 146, 604, 113, 593, 88, 600,
59, 637, 39, 668, 48, 693, 78, 716, 102, 760, 109, 788, 97, 817, 72