310, 499, 372, 498, 406, 477, 417, 453, 415, 407, 391, 372, 360,
385, 323, 406, 286, 399, 271, 368, 268, 307, 268, 259, 312, 248, 354,
245, 397, 247, 407, 218, 414, 182, 446, 167, 488, 165, 519, 173, 525,
219, 509, 275, 491, 319, 490, 360, 504, 421, 530, 474, 546, 510, 573,
528, 607, 516, 620, 483, 614, 223, 609, 174, 608, 118, 639, 92, 670,
86, 712, 84