228, 519, 284, 494, 267, 441, 276, 391, 277, 352, 266, 314, 260,
254, 261, 195, 291, 165, 337, 148, 394, 150, 443, 163, 465, 203, 463,
258, 468, 296, 490, 334, 499, 378, 514, 457, 529, 513, 546, 536, 588,
548, 631, 526, 690, 496, 735, 463, 745, 422, 729, 372, 690, 331, 667,
293, 666, 254, 670, 207, 690, 183, 715, 157, 727, 149