217, 453, 218, 415, 225, 397, 242, 364, 269, 329, 298, 305, 333,
289, 352, 267, 360, 243, 389, 238, 399, 213, 389, 160, 376, 120, 376,
93, 405, 82, 439, 82, 481, 81, 521, 87, 536, 99, 534, 139, 539, 166,
578, 210, 602, 249, 625, 289, 630, 322, 610, 328, 601, 344, 608, 370,
640, 410, 654, 450, 664, 499, 668, 548, 680, 563, 697, 545, 711, 524,
729, 468, 737, 401, 741, 354, 726, 285, 712, 245, 737, 296, 778, 298,
789, 239