224, 537, 252, 536, 257, 501, 254, 463, 256, 392, 276, 387, 305,
387, 309, 365, 307, 334, 292, 328, 283, 309, 284, 262, 300, 254, 307,
228, 305, 203, 306, 177, 337, 172, 361, 176, 363, 200, 369, 220, 471,
223, 475, 269, 474, 330, 473, 352, 599, 360, 600, 411, 601, 443, 604,
460, 643, 464, 653, 457, 651, 326, 632, 310, 550, 311, 548, 240, 648,
236, 647, 124, 637, 110, 467, 102, 462, 19, 749, 19, 754, 122, 728,
133, 720, 187, 781, 195, 782, 260