288, 549, 321, 559, 354, 563, 376, 568, 392, 561, 410, 555, 443,
560, 497, 573, 554, 576, 594, 569, 625, 549, 641, 517, 651, 488, 652,
458, 644, 435, 321, 432, 253, 412, 217, 385, 209, 361, 214, 354, 288,
375, 315, 365, 324, 346, 320, 335, 229, 322, 214, 309, 225, 289, 261,
271, 295, 263, 490, 264, 517, 255, 519, 233, 511, 215, 399, 192, 325,
166, 301, 148, 295, 123, 309, 111, 472, 134, 507, 142, 543, 158, 586,
188, 599, 211, 604, 246, 593, 271, 579, 296, 569, 317, 573, 346, 584,
369, 600, 381, 798, 382, 803, 364, 799, 320, 792, 299, 674, 286, 649,
265, 643, 238, 651, 205, 650, 167, 637, 140, 602, 122, 572, 113, 535,
109, 468, 101, 441, 94, 420, 78, 425, 64, 446, 56, 496, 60, 545, 67,
596, 79, 629, 92, 652, 109, 670, 135, 680, 163, 683, 189, 690, 212,
706, 228, 738, 213