240, 476, 249, 441, 265, 423, 287, 425, 301, 438, 311, 470, 325,
509, 339, 543, 353, 564, 382, 580, 415, 569, 426, 530, 450, 453, 472,
410, 471, 357, 459, 314, 443, 289, 422, 260, 383, 238, 297, 193, 277,
158, 282, 139, 299, 115, 326, 107, 388, 114, 430, 132, 471, 180, 494,
223, 505, 259, 517, 314, 522, 382, 533, 445, 550, 488, 565, 501, 604,
520, 627, 507, 640, 485, 641, 427, 630, 388, 611, 335, 566, 209, 560,
150, 578, 106, 598, 78, 621, 70, 642, 67, 667, 66, 684, 81, 698, 100,
716, 127, 724, 161, 731, 208, 748, 283, 768, 358, 775, 393, 774, 496